----- UI / Menu -----
週限次=Limit
武器突破材料=Weapon Ascension
掉落高級技能材料=Weekly Boss (30)
怪盜升級材料=Char Lv. (20)
大量魂石=Soul Stones (20)
面具升級材料=Persona Lv. (20)
武器升級材料=Weapon Lv. (20)
技能升級材料=Skill Lv. (30)
怪盜潛能材料=Char Ascend (30)
武器突破材料=Wpn Ascend (30)

票務等級提升至=Area Ticket is Upgraded to level 

----- General Skills -----
戰鬥技巧=Combat Skills

// Fire
亞基=Agi
亞基拉歐=Agilao
亞基達因=Agidyne
瑪哈拉基=Maragi
瑪哈拉基翁=Maragion
瑪哈亞基達因=Maragidyne

// Ice
布芙=Bufu
布芙拉=Bufula
布芙達因=Bufudyne
瑪哈布芙=Mabufu
瑪哈布芙拉=Mabufula
瑪哈布芙達因=Mabufudyne
鑽石星辰=Diamond Dust

// Lightning
吉歐=Zio
吉歐加=Zionga
吉歐達因=Ziodyne
瑪哈吉歐=Mazio
瑪哈吉歐加=Mazionga
瑪哈吉歐達因=Maziodyne

// Wind
加爾=Garu
加爾拉=Garula
加爾達因=Garudyne
瑪哈加爾=Magaru
瑪加爾拉=Magarula
瑪哈加爾達因=Magarudyne

// Psyche
賽=Psi
賽歐=Psio
賽達因=Psiodyne
瑪哈賽=Mapsi
瑪哈賽歐=Mapsio
瑪哈賽達因=Mapsiodyne

// Nuclear
芙雷=Frei
芙雷拉=Freila
芙雷因=Freidyne
瑪哈芙雷=Mafrei
瑪哈芙雷拉=Mafreila
瑪哈芙雷因=Mafreidyne

// Bless
克哈=Kouha
克加=Kouga
克加翁=Kougaon
瑪哈克哈=Makouha
瑪哈克加=Makouga
瑪哈克加翁=Makougaon

// Curse
耶哈=Eiha
耶加=Eiga
耶加翁=Eigaon
瑪哈耶哈=Maeiha
瑪哈耶加=Maeiga
瑪哈耶加翁=Maeigaon
姆多=Mudo
姆多翁=Mudoon
瑪哈姆多=Mamudo
瑪哈姆多翁=Mamudoon

// Almighty (Needs TW Text)
메기도=Megido
메기도라=Megidola
메기도라온=Megidolaon

// Recovery (Needs TW Text)
迪亞=Dia
梅迪亞=Media
// Diarama
// Mediarama
// Mediarahan
// Recarm
// Samarecarm
// Baisudi
// Mabaisudi
// Patra
// Me Patra

// Buffs (Needs TW text)
타루카자=Tarukaja
라쿠카자=Rakukaja
스쿠카자=Sukukaja
마하타루카=Matarukaja
마하라쿠카자=Marakukaja
마하스쿠카자=Masukukaja
// Dekunda

// Debuffs (Needs TW Text)
// Tarunda
// Matarunda
拉昆達=Rakunda
瑪哈拉昆達=Marakunda
// Sukunda
// Masukunda
// Debilitate
// Dekaja

----- Persona / Demons -----
可登錄=Can Register
可合體=Can Fuse
未登錄=Not Registered
面具階級=Class

// Class I
玄武=Genbu
男夢魔=Incubus
希路奇=Silky
比利士=Berith
雙角獸=Bicorn
幸魂=Saki Mitama
凱爾皮=Kelpie
惡靈=Mokoi
花魄=Hua Po
克魯波克魯=Koropokkuru
軟泥怪=Slime
安德拉斯=Andras
埃力格=Eligor
皮克希=Pixie
傑克燈籠=Jack-O'-Lantern
阿珈席翁=Agathion
曼陀羅=Mandrake

// Class II

// Class III

// Class IV

// Class V 

// Class VI

// Class VII

朱雀=Suzaku
犬神=Inugami
真神=Makami
高等皮克希=High Pixie
木葉天狗=Koppa Tengu
陰魔羅鬼=Onmoraki
歐若博司=Orobas
貓妖=Nekomata
飛天=Apsaras
木靈=Kodama
山靈=Sudama
獅爺=Shiisaa
和魂=Nigi Mitama
奇魂=Kushi Mitama
希路奇=Silky
女夢魔=Succubus
背負怪=Obariyon
比利士=Berith
玄武=Genbu
一本踏鞴=Ippon-Datara
傑克霜精=Jack Frost
天使= Angel
持國天=Daikokuten
歐特魯斯=Ortelus
貓將軍=Neko Shogun
權天使=Principality
天鈿女命=Ame-no-Uzume
拉彌亞=Lamia
式王子=Shiki-Ouji
阿努比斯=Anubis
瑟坦特=Sertanthe
大天使=Archangel
佛勞洛斯=Flauros
瑟坦特=Setanta
鬼=Oni
鵺=Nue
伊西絲=Isis
地獄天使=Hell Biker
白騎士=White Rider
拉克西斯=Lachesis
荒霸吐=Arahabaki
貝爾芬格=Belphegor
訶梨帝母=Hariti
單卡拉比=Decarabia
密特拉=Mythra
菊理媛=Kikurihime
埃力格=Eligor
安祖=Anzu
歐特魯斯=Orthrus
風鬼=Fuu-Ki
金鬼=Kin-Ki
黑軟泥怪=Black Slime
鬥牛士=Matador
可羅索=Clotho
鳳凰=Phoenix


----- Character-specific Skills -----
// Cattle

// Mont
勾手一躍=Hook Jump
冰之綻放=Ice Bloom
凜冬撕裂=Tears of Winter
寒冰之刃=Ice Blade
忘我=Selfless
刀尖上的舞者=Dancer on Knife's Edge
冰晶= <link\="s|119"><u>Ice Crystal</u></link>

// Closer

// Soy

// Okyann

// Puppet

// Moko

// Yuki

// Leo

// Fleuret

// Key

// Sepia

// Rin

// Riddle

// Joker

// Mona

// Skull

// Panther

// Fox

// Queen

// Navi (Oracle)

// Noir

// Crow

// Bui

-----

----- Persona Unique Skills -----
念動破壞=Nimble Destruction
